%%%%%%%%%%%%%%%%%%%%
%    %        %    %
%.%% % %%%%%% % %% %
% %              % %
% % %% %%  %% %%. %%
%      %G  G%   ...%
% % %% %%%%%% %%.%.%
% %   ......     %.%
% %%..   P....% %%.%
%    % ...... %  ..%
%%%%%%%%%%%%%%%%%%%%
