%%%%%%%%%%%%%%%%%%%%
%....%        %  ..%
%.%%.% %%%%%% % %% %
%.%              % %
%.% %% %%  %% %%  %%
%      %G  G%    . %
% % %% %%%%%% %% % %
% %              % %
% %%     P    % %% %
%    %   ..   %    %
%%%%%%%%%%%%%%%%%%%%
