%%%%%%%%%%%%%%%%%%%%
%  G G             %
%%%%%%%%%%%%%%%P%%%%
% %                %
% % %% %%% %% %%  %%
%      %    %      %
% % %% %%%%%% %% % %
% %              % %
% %%          % %% %
%    %        %    %
%%%%%%%%%%%%%%%%%%%%