%%%%%%%%%%%%%%%%%%%%
%    %        % .  %
% %% % %%%%%% % %% %
% %             .% %
% % %% %%  %% %%. %%
%      %    %   .  %
%%%%%%%%%%%%%%%%.%%%
%                  %
%  G           P.  %
%         G     .  %
%%%%%%%%%%%%%%%%%%%%
