%%%%%%%%%%%%%%%%%%%%
%  %        %  ..%
% %% % %%%%%% % %% %
% %              % %
% % %% %%  %% %%  %%
%      %G  G%    . %
% % %% %%%%%% %% % %
% %              % %
% %%     P    % %% %
%    %   ..   %    %
%%%%%%%%%%%%%%%%%%%%
