%%%%%%%%%%%%%%%%%%%%%%%%%%%%
%            %%            %
% %%%% %%%%% %% %%%%% %%%% %
% %%%% %%%%% %% %%%%% %%%% %
% %%%% %%%%% %% %%%%% %%%% %
%                    .     %
% %%%% %% %%%%%%%% %% %%%% %
% %%%% %% %%%%%%%% %% %%%% %
%      %%    %%    %%      %
%%%%%% %%%%% %% %%%%% %%%%%%
%%%%%% %%%%% %% %%%%% %%%%%%
%%%%%% %            % %%%%%%
%%%%%% % %%%%  %%%% % %%%%%%
         %        %         
%%%%%% % %%%%%%%%%% % %%%%%%
%%%%%% %            % %%%%%%
%%%%%% % %%%%%%%%%% % %%%%%%
%            %%            %
% %%%% %%%%% %% %%%%% %%%% %
% %%%% %%%%% %% %%%%% %%%% %
%   %%                %%   %
%%% %% %% %%%%%%%% %% %%.%%%
%%% %% %% %%%%%%%% %% %%.%%%
%   G  %%    %%    %%  .  .%
% %%%%%%%%%% %% %%%%%%%%%% %
%  o   PG                  %
%%%%%%%%%%%%%%%%%%%%%%%%%%%%
