%%%%%%%
% Po  %
% %%% %
% %.  %
% %%% %
%. G  %
%%%%%%%
