%%%%%%%
% P   %
% %%% %
% %.  %
% %%% %
%. G o%
%%%%%%%
